
NO textures/xpm/eagle.xpm
SO textures/xpm/colorstone.xpm
EA textures/xpm/wood.xpm
WE textures/xpm/purplestone.xpm

C 50,167,255
F 59,59,59

1111111111111111111111111zz
100000E000000010000000001
1011111111111010111111101
1010000000001010000000101
1010111111101010111110101
1010100000101010100000101
1010101110101010101111101
1010101010101010101000001
1011101011101010111011111
1000001010001010001000001
1111111111111111111111111